20 20
17 28 25 25 33 33 25 27 48 17 50 17 17 17 48 17 17 56 59 17 
17 18 0 3 3 3 0 16 56 57 58 17 17 17 56 59 17 17 56 57 
17 36 10 0 0 11 12 16 17 17 17 17 17 17 17 56 59 17 17 17 
17 17 18 0 0 19 20 16 17 44 13 14 15 43 17 17 56 57 57 57 
28 33 34 0 0 0 0 16 17 18 21 22 23 16 17 17 17 17 17 17 
36 9 10 3 0 0 3 16 17 18 3 4 3 16 17 28 33 33 27 17 
42 17 18 0 0 0 0 16 17 18 3 0 3 16 17 18 11 12 16 40 
50 17 18 0 3 0 0 32 33 34 0 0 0 24 33 34 19 20 16 48 
52 42 18 0 0 0 0 0 2 2 2 0 2 2 2 0 3 3 16 48 
17 50 36 9 9 9 9 9 9 10 0 0 0 0 0 0 0 0 16 56 
60 58 28 33 25 33 25 33 27 18 0 0 11 12 0 0 0 0 16 17 
50 17 18 3 0 0 4 0 16 18 0 0 19 20 3 0 0 0 16 17 
58 17 18 0 8 10 0 0 16 18 4 3 0 11 12 0 0 0 32 25 
17 17 18 4 16 18 0 4 16 18 4 0 0 19 20 0 0 4 4 4 
25 33 34 4 16 18 0 4 16 18 0 0 0 0 0 0 3 8 9 9 
0 4 0 0 16 18 3 0 16 18 0 8 10 3 0 0 8 35 17 17 
0 0 0 3 16 18 0 0 16 18 0 16 18 1 1 1 16 49 17 40 
10 0 3 8 35 18 0 3 32 34 0 16 18 1 1 1 16 17 17 48 
18 1 1 16 17 18 0 4 4 0 0 16 18 1 1 1 16 17 40 51 
36 9 9 35 17 36 9 9 9 9 9 35 36 9 9 9 35 17 48 17 

0 0 0 0 0 0 0 0 0 0 0 0 0 0 0 0 0 0 0 0 
0 0 1 1 1 1 1 0 0 0 0 0 0 0 0 0 0 0 0 0 
0 0 0 1 1 0 0 0 0 0 0 0 0 0 0 0 0 0 0 0 
0 0 0 1 1 0 0 0 0 0 0 0 0 0 0 0 0 0 0 0 
0 0 0 1 1 1 1 0 0 0 0 0 0 0 0 0 0 0 0 0 
0 0 0 1 0 1 1 0 0 0 0 0 0 0 0 0 0 0 0 0 
0 0 0 1 1 1 1 0 0 0 0 0 0 0 0 0 0 0 0 0 
0 0 0 1 1 1 1 0 0 0 0 0 0 0 0 0 0 0 0 0 
0 0 0 1 1 1 0 1 0 0 0 0 0 0 0 1 1 1 0 0 
0 0 0 0 0 0 0 0 0 0 1 1 1 1 1 1 1 1 0 0 
0 0 0 0 0 0 0 0 0 0 1 1 0 0 1 1 1 1 0 0 
0 0 0 1 1 1 1 1 0 0 1 1 0 0 1 1 1 0 0 0 
0 0 0 1 0 0 1 1 0 0 1 1 1 0 0 1 1 1 0 0 
0 0 0 1 0 0 1 1 0 0 1 1 1 0 0 1 1 1 1 1 
0 0 0 1 0 0 1 1 0 0 1 1 1 1 1 1 1 0 0 0 
1 1 1 1 0 0 1 1 0 0 1 0 0 1 1 1 0 0 0 0 
1 1 1 1 0 0 1 1 0 0 1 0 0 0 0 0 0 0 0 0 
0 1 1 0 0 0 1 1 0 0 1 0 0 0 0 0 0 0 0 0 
0 0 0 0 0 0 1 1 1 1 1 0 0 0 0 0 0 0 0 0 
0 0 0 0 0 0 0 0 0 0 0 0 0 0 0 0 0 0 0 0 

