10 10
17 17 17 17 17 18 5 3 3 16 
17 17 17 17 17 18 3 3 3 32 
28 33 25 33 25 34 0 0 0 0 
18 2 2 0 0 4 4 0 4 4 
18 2 2 0 4 0 0 0 0 6 
18 0 5 0 8 9 9 10 0 8 
18 0 0 0 32 27 17 18 0 16 
36 10 0 4 0 24 25 26 0 16 
17 18 0 4 0 0 0 0 0 16 
17 18 4 4 6 8 9 9 9 35 

0 0 0 0 0 0 0 1 1 0 
0 0 0 0 0 0 1 1 1 0 
0 0 0 0 0 0 1 1 1 1 
0 1 1 1 1 1 1 1 1 1 
0 1 1 1 1 1 1 1 1 1 
0 1 0 1 0 0 0 0 1 0 
0 1 1 1 0 0 0 0 1 0 
0 0 1 1 1 0 0 0 1 0 
0 0 1 1 1 1 1 1 1 0 
0 0 1 1 1 0 0 0 0 0 

