25 26
1 1 1 1 1 1 1 20 0 0 0 0 0 0 0 0 0 0 0 0 0 0 0 0 0 
49 49 48 1 1 1 1 1 20 18 1 1 1 1 20 19 19 0 0 0 0 0 0 0 0 
0 0 33 1 1 1 1 1 1 15 16 16 16 16 16 16 17 20 0 0 0 0 0 0 0 
0 0 33 1 1 1 1 1 15 31 31 31 31 31 31 31 31 17 20 0 0 0 0 0 0 
0 0 18 1 1 1 1 15 31 31 31 46 46 46 46 31 31 31 17 20 0 0 0 0 0 
0 18 1 1 1 1 15 31 31 31 47 1 24 25 1 45 31 31 31 17 35 0 0 0 0 
18 1 1 1 1 1 30 31 31 47 1 11 39 40 12 1 45 31 31 32 35 0 0 0 0 
1 1 1 1 1 1 30 31 32 1 13 26 54 55 27 14 1 30 31 32 35 0 0 0 0 
48 1 1 1 1 1 30 31 32 1 28 3 2 2 3 29 1 30 31 32 35 0 0 0 0 
0 48 1 1 1 1 30 31 32 1 43 3 2 2 3 44 1 30 31 32 35 0 0 0 0 
0 0 49 48 1 1 30 31 32 1 58 3 2 2 3 59 1 30 31 32 35 0 0 0 0 
0 0 0 33 1 1 30 31 31 17 56 57 2 2 41 42 15 31 31 32 35 0 0 0 0 
0 0 0 0 48 1 45 31 31 31 17 1 1 1 1 15 31 31 31 47 35 0 0 0 0 
0 0 0 0 33 1 1 45 31 31 32 1 1 1 1 30 31 31 47 1 35 0 0 0 0 
0 0 0 0 0 48 1 1 45 46 47 1 1 1 1 45 46 47 1 50 0 0 0 0 0 
0 0 0 0 0 33 1 1 1 1 1 1 1 1 1 1 1 1 50 0 0 0 0 0 0 
0 0 0 0 0 0 48 1 1 1 1 21 22 23 1 1 50 49 0 0 0 0 0 0 0 
0 0 0 0 0 0 33 1 1 1 1 36 0 38 1 50 0 0 0 0 0 0 0 0 0 
0 0 0 0 0 0 0 48 1 1 1 36 0 50 49 0 0 0 0 0 0 0 0 0 0 
0 0 0 0 0 0 0 33 1 1 1 1 0 0 0 0 0 0 0 0 0 0 0 0 0 
0 0 0 0 0 0 0 33 1 1 1 50 0 0 0 0 0 0 0 0 0 0 0 0 0 
0 0 0 0 0 0 0 33 1 1 50 0 0 0 0 0 0 0 0 0 0 0 0 0 0 
0 0 0 0 0 0 0 0 48 50 0 0 0 0 0 0 0 0 0 0 0 0 0 0 0 
0 0 0 0 0 0 0 0 0 0 0 0 0 0 0 0 0 0 0 0 0 0 0 0 0 
0 0 0 0 0 0 0 0 0 0 0 0 0 0 0 0 0 0 0 0 0 0 0 0 0 
0 0 0 0 0 0 0 0 0 0 0 0 0 0 0 0 0 0 0 0 0 0 0 0 0 

1 1 1 1 1 1 1 1 0 0 0 0 0 0 0 0 0 0 0 0 0 0 0 0 0 
0 0 1 1 1 1 1 1 1 1 1 1 1 1 1 0 0 0 0 0 0 0 0 0 0 
0 0 0 1 1 1 1 1 1 2 2 2 2 2 2 2 2 1 0 0 0 0 0 0 0 
0 0 0 1 1 1 1 1 2 2 2 2 2 2 2 2 2 2 1 0 0 0 0 0 0 
0 0 1 1 1 1 1 2 2 2 2 2 2 2 2 2 2 2 2 1 0 0 0 0 0 
0 1 1 0 1 1 2 2 2 2 2 1 0 0 1 2 2 2 2 2 0 0 0 0 0 
1 1 1 1 1 1 2 2 2 2 1 0 0 0 0 1 2 2 2 2 0 0 0 0 0 
1 1 1 1 1 1 2 2 2 1 0 0 0 0 0 0 1 2 2 2 0 0 0 0 0 
1 1 1 1 1 1 2 2 2 1 0 0 0 0 0 0 1 2 2 2 0 0 0 0 0 
0 1 1 1 1 1 2 2 2 1 0 0 0 0 0 0 1 2 2 2 0 0 0 0 0 
0 0 0 1 1 1 2 2 2 1 0 0 0 0 0 0 1 2 2 2 0 0 0 0 0 
0 0 0 0 1 1 2 2 2 2 0 0 0 0 0 0 2 2 2 2 0 0 0 0 0 
0 0 0 0 1 1 2 2 2 2 2 1 1 1 1 2 2 2 2 2 0 0 0 0 0 
0 0 0 0 0 1 1 2 2 2 2 1 1 1 1 2 2 2 2 1 0 0 0 0 0 
0 0 0 0 0 1 1 1 2 2 2 1 1 1 1 2 2 2 1 1 0 0 0 0 0 
0 0 0 0 0 0 1 1 1 1 1 1 1 1 1 1 1 1 1 0 0 0 0 0 0 
0 0 0 0 0 0 1 1 1 1 1 0 0 0 1 1 1 0 0 0 0 0 0 0 0 
0 0 0 0 0 0 0 1 1 1 1 0 0 0 1 1 0 0 0 0 0 0 0 0 0 
0 0 0 0 0 0 0 1 1 1 1 0 0 1 0 0 0 0 0 0 0 0 0 0 0 
0 0 0 0 0 0 0 0 1 1 1 1 0 0 0 0 0 0 0 0 0 0 0 0 0 
0 0 0 0 0 0 0 0 1 1 1 1 0 0 0 0 0 0 0 0 0 0 0 0 0 
0 0 0 0 0 0 0 0 1 1 1 0 0 0 0 0 0 0 0 0 0 0 0 0 0 
0 0 0 0 0 0 0 0 3 3 0 0 0 0 0 0 0 0 0 0 0 0 0 0 0 
0 0 0 0 0 0 0 0 0 0 0 0 0 0 0 0 0 0 0 0 0 0 0 0 0 
0 0 0 0 0 0 0 0 0 0 0 0 0 0 0 0 0 0 0 0 0 0 0 0 0 
0 0 0 0 0 0 0 0 0 0 0 0 0 0 0 0 0 0 0 0 0 0 0 0 0 

